SORU,CEVAP
"Referans alabileceğimiz web siteleriniz nelerdir?","https://www.saily.com/"
"Randevuyu iptal etmek istersem ne yapmalıyım?","Bizimle telefon ile İletişime geçerek Randevunuzu iptal edebilirsiniz. Şube iletişim bilgileri paylaşılabilir."
"Randevumu erteleyebilir miyim?","Bizimle telefon ile İletişime geçerek Randevunuzu erteleyebilirsiniz. Şube iletişim bilgileri paylaşılabilir."
Aynı gün içinde randevu almak mümkün mü?,	Evet.								
Randevusuz gelmek mümkün mü?,	Randevu alınması yoğunluk esnasında hastayı bekletmemek için tercih edilir fakat randevusuz hasta da kabul ediyoruz								
Randevu onayı nasıl veriliyor? SMS mi arama mı?,	Randevunuz sistemlerimize işlendikten sonra telefon ile arama yaparak randevunuzu onaylıyoruz.								
Şubeler arası randevu aktarımı yapılabiliyor mu?,	Evet. Dilerseniz randevu değişkiliğiniz için bizimle iletişime geçebilirsiniz								
İşitme testi (odyometri) nasıl yapılır?,	İŞİTME TESTİ, HASTANIN KULAĞINA KULAK ÜSTÜ KULAKLIK TAKILIR VE ELİNE YANIT VERMESİ İÇİN BİR BUTON VERİLİR. HASTAYA SİNYALLER GÖNDERİLİR VE HASTADAN DUYDUĞU SİNYAL SESLERİNE ELİNE VERİLEN BUTON İLE YANIT VERMESİ BEKLENİR.								
İşitme testi ücretsiz mi?,	İŞİTME TESTİ KARŞILIĞINDA RAPOR TALEP EDİLMEKTE İSE İŞİTME TESTİMİZİN 1500TL ÜCRETİ VARDIR FAKAT RAPORSUZ SADECE İŞİTME KAYBI VAR MI YOK MU BUNU TESPİT ETMEK İSTİYOR İSE ÜCRETSİZ OLARAK YAPILIR.								
Cihaz denemesi yapabilir miyim?,	İŞİTME CİHAZI DENEMESİ YAPILABİLİR. AVRUPA STANDARTLARINDA BULUNAN İŞİTME CİHAZI DENEMELERİ HASTANIN İHTİYACINA VE İŞİTME KAYBINA GÖRE BELİRLENİR.								
Deneme süresi ne kadar?,	İŞİTME CİHAZI DENEMESİ İÇİN MİNİMUM 30-40DK SÜRE GEREKMEKTEDİR.								
Cihaz kalibrasyonu veya ayar hizmetiniz var mı?,	EVET								
Kulak kalıbı alma işlemi ne kadar sürer?,	KULAK KALIBI ALMA İŞLEMİ 15 DK SÜRER								
Çocuklar için ayrı bir hizmetiniz var mı?,	ÇOCUKLAR İÇİN İŞİTME TESTİ VE İŞİTME CİHAZI KULLANIYOR İSE PEDİATRİK İŞİTME CİHAZI AYARLAMASI YAPILIR. KULAK KALIBI ALINIR. ROGER SİSTEM UYGULAMASI YAPILIR.								
Yaşlılar için evde test veya hizmet veriliyor mu?,	EV HİZMETİMİZ BULUNMAKTADIR.								
Pil veya aksesuar satışı yapıyor musunuz?,	İŞİTME CİHAZI PİLİ VE CİHAZIN YEDEK PARÇA (HOPARLÖR,BOYNUZ,PİL KAPAĞI, KABİN DEĞİŞİMİ, HORTUM DEĞİŞİMİ VS.) SATIŞI YAPIYORUZ								
Cihaz bakımı ne sıklıkla yapılmalı?,	İŞİTME CİHAZI BAKIMLARI RUTİN 6 AYDA BİR YAPILMASI GEREKMEKTEDİR. CİHAZIN ÖMRÜNÜ UZATMAK İÇİN TERCİH EDİLİR. EVDE YAPILMASI GEREKEN BAKIMLARIN HAFTADA BİR DÜZENLİ OLARAK YAPILMASI İÇİN HASTANIN BİLGİLENDİRİLMESİ GEREKİR								
İşitme cihazı fiyatları neye göre değişir?,	İŞİTME CİHAZI FİYATLARI CİHAZIN KALİTESİNE, SEGMENTİNE, ÖZELLİKLERİNE, PİLLİ VEYA SARJLI OLMASINA GÖRE, ÜRETİLDİĞİ ÜLKEYE, YENİ SERİ OLMASINA, GARANTİ SÜRESİNE GÖRE DEĞİŞİR.								
SGK işitme cihazı desteği veriyor mu?,	SGK EMEKLİ İÇİN KULAK BAŞINA 4239 TL ÖDEME YAPMAKTADIR. ÇALIŞAN İÇİN İSE KULAK BAŞINA 3391 TL ÖDEME YAPMAKTADIR. BU ÖDEME TUTARLARI CİHAZIN LİSTE FİYATI ÜZERİNDEN DÜŞÜLEREK HESAPLANIR.								
SGK indirimi nasıl uygulanır?,	SGK İNDİRİMİNDEN YARARLANMAK İSTEYEN HASTA ÖNCELİKLİ OLARAK BİR DEVLET HASTANESİNİN KULAK BURUN BOĞAZ BÖLÜMÜNE MUAYENE OLDUKTAN SONRA İŞİTME TESTİ İÇİN ODYOLOJİ BÖLÜMÜNE SEVK EDİLMEDİR. İŞİTME TESTİNİ YAPTIRDIKTAN SONRA ALACAĞI İŞİTME CİHAZININ ÖZELLİKLERİNİ TAŞIYAN BİR RAPOR VE REÇETEYİ MUAYENE OLDUĞU KULAK BURUN BOĞAZ DOKTORUNA YAZDIRMALIDIR.								
Taksitli ödeme var mı?,	İŞİTME CİHAZINA ÖDEME KOLAYLIĞI SAĞLAMAK İÇİN KREDİ KARTINA TAKSİT SEÇENEĞİMİZ BULUNMAKTAIDR								
Peşin ödemede indirim oluyor mu?,	EVET								
Kampanya dönemlerini nasıl öğrenebilirim?,	KAMPANYA DÖNEMLERİNİ İNSTAGRAM HESAPLARINDAN BİZİ TAKİP EDEREK, WHATSAPP DURUMLAR ÜZERİNDEN YAPTIĞIMIZ PAYLAŞIMLARI TAKİP EDEREK ÖĞRENEBİLİRSİNİZ.								
Fiyatlar her şubede aynı mı?,	FİYAT LİSTELERİ HER ŞUBEDE AYNIDIR AYNI KAMPANYA VE İNDİRİM ORANLARI MEVCUTTUR.								
Cihaz fiyatına garanti ve servis dahil mi?,	İŞİTME CİHAZI FİYATLARINA 2 YIL GARANTİ DAHİLDİR. GARANTİ SÜRESİ BİTTİKTEN SONRA TEKNİK SERVİS ÜCRETE TABİİDİR.								
Fiyat bilgisi telefonla veriliyor mu?,	İŞİTME CİHAZINI DENEME YAPMADAN KARAR VERMEK DOĞRU OLMADIĞINDAN DOLAYI İŞİTME CİHAZI FİYATLARI TELEFONDAN BİLGİ VERİLMİYOR. ANCAK ARAŞTIRIP MEMNUN KALDIĞI BİR MARKA VE MODEL VAR İSE O ŞEKİLDE LİSTE FİYATLARI BİLDİRİLİR AMA ASIL İNDİRİM FİYAATLARI YİNE ŞUBEDE SÖYLENİR								
Ücretsiz deneme veya iade hakkı var mı?,	İŞİTME CİHAZI DENEMELERİ ŞUBEDE YAPILDIĞI SÜRE İLE SINIRLIDIR FAKAT BAZI İSTİSNAİ DURUM VE HASTALARDA EVDE DENEMESİ İÇİN İZİN VERİYORUZ. BU SÜRE MAKSİMUM 7 GÜN İLE SINIRLIDIR. 7 GÜN İÇERİSİNDE KARARINI BİLDİRMESİ GEREKEKTEDİR. İADE HAKKI BU SEBEPTEN DOLAYI BULUNMAMAKTADIR.								
Hangi markaların işitme cihazlarını satıyorsunuz?,	PHONAK, WIDEX , OTİCON, UNİTRON, SİGNİA								
Hangi modeller öne çıkıyor?,	PHONAK INFINIO SPHERE, OTİCON İNTENT, WİDEX MOMENT, WİDEX SMART RİC, WİDEX ALLURE, PHONAK LUMİTY, SİGNİA SİLK								
Dijital işitme cihazı nedir?,	Çevredeki sesleri mikrofonla alıp bu sesleri dijital sinyallere dönüştüren, ardından kişinin işitme kaybı türü ve derecesine göre işleyip güçlendirerek kulağa veren elektronik bir cihazdır.								
Şarjlı işitme cihazı var mı?,	SARJLI İŞİTME CİHAZI MEVCUT								
Bluetooth veya akıllı telefonla uyumlu modelleriniz var mı?,	YENİ NESİL İŞİTME CİHAZLARININ HEPSİ BLUETOOTH İLE ÇALIŞMAKTADIR (KULAK İÇİ İŞİTME CİHAZLARI HARİÇ) PHONAK MARKA EVRENSEL BAĞLANTI SAYESİNDE SADECE AKILLI TELEFON DEĞİL EK AKSESUAR OLMADAN TELEVİZYONA, ARACA DA BAĞLANABİLMEKTEDİR. DİĞER İŞİTME CİHAZI MODELLERİ İÇİN UYGULAMA YAPACAĞI TELEFONUN ASHA STANDARTLARINA UYGUN OLMASI GEREKMEKTEDİR.								
Suya veya tere dayanıklı modeller mevcut mu?,	SATMIŞ OLDUĞUMUZ İŞİTME CİHAZLARINDA IP68 SERTİFİKASI MEVCUTTUR. BU SERTİFİKA SUYA VE TOZA KARŞI DAYANIKLILIĞI İFADE EDER.								
Kulak içi ve kulak arkası farkı nedir?,	KULAK İÇİ İŞİTME CİHAZLARINDA TEK HOPARLÖR VE TEK MİKROFON BULUNMAKTADIR BU DA SENİN 360 DERECE TOPLANMASINI VE KULAĞA İLETİLMESİNİ DAHA ZAYIF KILAR. FAKAT KULAK ARKASI İŞİTME CİHAZINDA AÇISAL OLARAK SESİ TOPLAMASI VE KULAĞA İLETMESİ DAHA GÜÇLÜDÜR VE DAHA FAZLA KAZANÇ SAĞLAR								
Cihazı kim belirliyor — kullanıcı mı, uzman mı?,	CİHAZI HEM KULLANICI HEM UZMAN AYNI ANDA BELİRLER. KULLANICI YAŞAM BİÇİMİNDE NASIL BİR ŞEY İSTEDİĞİNİ VE NASIL BİR CİHAZIN KENDİSİNE UYGUN OLACAĞINI UZMANA BELİRTİR UZMAN DENEYİMLERİNDEN YARARLANARAK HANGİ CİHAZIN UYGUN OLDUĞUNU TEKNİK ÖZELLİKLERİ ANLATARAK İFADE EDER. CİHAZIN ASIL BELİRLEYİCİSİ KULLANICIDIR. KULLANICININ KULAĞINA CİHAZ TAKILDIĞI ANDAN İTİBAREN CİHAZ İLE İLGİLİ SES KALİTESİ GİBİ ÖZELLİKLER CİHAZI KULLANILABİLİR KILAR.								
İşitme cihazlarının garanti süresi ne kadar?,	ÇOĞU İŞİTME CİHAZININ 2 YIL GARANTİSİ VARDIR FAKAT WİDEXTE 220 SERİSİNDEN SONRA 3 YIL GARANTİ VARDIR. PHONAKTA DA YENİ ÇIKARTTIĞI INFINIO SERİSİNDE 3 YIL GARANTİ VARDIR.								
Garanti kapsamında neler yer alıyor?,	İŞİTME CİHAZININ YEDEK PARÇA DEĞİŞİMİ, 6 AYDA BİR YAPILAN DETAYLI GENEL BAKIMLARI, YAZILIM GÜNCELLEMELERİ, ARIZALI PARÇA DEĞİŞİMİ GARANTİ KAPSAMINDA YER ALIR								
Cihaz arızalanırsa ne yapmalıyım?,	CİHAZ ARIZALANIRSA İLK ÖNCE CİHAZI ALDIĞINIZ İŞİTME CİHAZI MERKEZİNDE DURUMU BİLDİRMENİZ GEREKMEKTEDİR. UZMANINIZIN ŞUBE İÇERİSİNDE YAPABİLECEĞİ BİR ARIZA İSE UZMANINIZ AYNI GÜN İÇİNDE CİHAZI YAPIP SİZE VEREBİLİR FAKAT DAHA DETAYLI BİR BAKIM VE ARIZA YAPILMASI GEREKİYOR İSE TEKNİK SERVİSE GÖNDERİLMESİ GEREKMEKTEDİR								
Garanti süresi dolduktan sonra servis ücreti nedir?,	GARANTİ SÜRESİ DOLDUKTAN SONRA TEKNİK SERVİSE GİDEN CİHAZIN ARIZASI İÇİN FİYAT TESPİTİ YAPILIYOR VE BU FİYATLANDIRMA HASTAYA SÖYLENMEDEN, HASTA ONAYLAMADAN YAPILMIYOR O YÜZDEN BU SEBEPLE BELİRLİ BİR SERVİS ÜCRETİ YOK								
Yedek parça temini yapılıyor mu?,	YAPILIYOR								
Cihaz bakım süresi ne kadar sürer?,	GARANTİ BELGESİNDE BELİRTİLEN SÜRE AZAMİ 21 İŞ GÜNÜ OLARAK BELİRTİLİR FAKAT İŞİTME CİHAZI FİRMALARI GENEL OLARAK 7-10 GÜN İÇERİSİNDE CİHAZI BAYİYE YAPILMIŞ BİR ŞEKİLDE GERİ GÖNDERİR								
Pil değişimi veya temizlik hizmetiniz var mı?,	VAR								
Garanti belgesi nasıl temin edilir?,	GARANTİ BELGESİ CİHAZLARIN TESLİMAT AŞAMASINDA FATURA İLE BİRLİKTE TESLİM EDİLİR								
Fatura olmadan garanti geçerli mi?,	GEÇERLİDİR.								
Cihazımı başka şubeye getirirsem servis yapılır mı?,	YAPILIR								
Cihaz denemesi için kimlik gerekiyor mu?,	DENEME İÇİN KİMLİK GEREKLİ DEĞİL. FAKAT CİHAZI ALDIKTAN SONRA HASTA TAKİBİ VE SAĞLIK BAKANLIĞI DENETİM DEFTERİNE İŞLEMEK İÇİN KİMLİK BİLGİLERİ GEREKLİDİR.								
Randevu bilgilerim gizli tutuluyor mu?,	TABİ Kİ. RANDVEU BİLGİLERİ MERKEZ ÇALIŞANLARI DIŞINDA KİMSE İLE PAYLAŞILMAZ. GİZLİLİK ESASTIR.								
Kişisel veriler nasıl korunuyor?,	DİJİZİN, KVKK ONAYI TELEFONUNUZA GELEN KOD İLE KORUMA ALTINA ALINIYOR.								
Şirketinizin merkezi nerede?,	KADIKÖY- GÖZTEPEDE ANA ŞUBEMİZ BULUNUYOR.								
Şirket ne zamandır faaliyet gösteriyor?,	SAILY İŞİTME CİHAZLARI MERKEZİ 15 YILDIR FAALİYET GÖSTERMEKTEDİR								
Uzmanlarınızın eğitim durumu nedir?,	YÜKSEK LİSANS								
Yurt dışına satış yapıyor musunuz?,	YURT DIŞINDA AYRI BİR MERKEZİMİZ BULUNMUYOR. ANCAK CİHAZLARIMIZDA UZAKTAN BAĞLANTI SEÇENEKLERİ MEVCUT OLDUĞU İÇİN DÜNYANIN HER YERİNE BAĞLANTI SAĞLAMAMIZ MÜMKÜN.								
Ürün iade politikası nedir?,	ÜRÜNLER KİŞİYE ÖZEL PROGRAMLANDIĞI VE ŞUBELERDE DENEME YAPILARAK ALINDIĞI İÇİN İADE SEÇENEĞİ BULUNMUYOR.								
Cihaz kiralama seçeneği var mı?,	MAALESEF. CİHAZLAR KİŞİYE ÖZEL PROGRAMLANDIĞI İÇİN KİRALAMA SEÇENEĞİ YOK.								
Yetkili bayi olduğunuzu nasıl anlarım?,	İşitme cihazı markalarının web sitelerinde genellikle Yetkili Satıcılar, Bayilerimiz, Dealer Locator bölümü bulunur. Firmanızın ticari unvanı, adresi ve iletişim bilgileri burada yer alıyor. Burada ismimiz olduğu için yetkili olduğumuzu anlayabilirsiniz.								
“Hangi ilaç iyi gelir?”, "KVKK kutusunu işaretleyip, Ad Soyad ; Telefon bilgilerinizi örnekteki gibi paylaşırsanız (Örn: Ad Soyad ; 05XX XXXXXXX), müşteri temsilcimiz en kısa sürede size dönüş sağlayacaktır."
“Kulak çınlaması neden olur?”, "KVKK kutusunu işaretleyip, Ad Soyad ; Telefon bilgilerinizi örnekteki gibi paylaşırsanız (Örn: Ad Soyad ; 05XX XXXXXXX), müşteri temsilcimiz en kısa sürede size dönüş sağlayacaktır."
“X markası sizden daha mı iyi?”, "KVKK kutusunu işaretleyip, Ad Soyad ; Telefon bilgilerinizi örnekteki gibi paylaşırsanız (Örn: Ad Soyad ; 05XX XXXXXXX), müşteri temsilcimiz en kısa sürede size dönüş sağlayacaktır."
“Hangi cihaz en iyisi?”,"KVKK kutusunu işaretleyip, Ad Soyad ; Telefon bilgilerinizi örnekteki gibi paylaşırsanız (Örn: Ad Soyad ; 05XX XXXXXXX), müşteri temsilcimiz en kısa sürede size dönüş sağlayacaktır."
“Doktorum ne önerir?”,"KVKK kutusunu işaretleyip, Ad Soyad ; Telefon bilgilerinizi örnekteki gibi paylaşırsanız (Örn: Ad Soyad ; 05XX XXXXXXX), müşteri temsilcimiz en kısa sürede size dönüş sağlayacaktır."
“Hangi ses frekansında işitme kaybım var?”,"KVKK kutusunu işaretleyip, Ad Soyad ; Telefon bilgilerinizi örnekteki gibi paylaşırsanız (Örn: Ad Soyad ; 05XX XXXXXXX), müşteri temsilcimiz en kısa sürede size dönüş sağlayacaktır."
“Evde kendi testimi nasıl yaparım?”,"KVKK kutusunu işaretleyip, Ad Soyad ; Telefon bilgilerinizi örnekteki gibi paylaşırsanız (Örn: Ad Soyad ; 05XX XXXXXXX), müşteri temsilcimiz en kısa sürede size dönüş sağlayacaktır."

